5
5
11111
10031
11011
12011
11111